// memory data file (do not edit the following line - required for mem load use)
// instance=/Tb_m/memo_i
// format=mti addressradix=d dataradix=b version=1.0 wordsperline=1 noaddress
0000010000111100
0000011110111000
0000100110010100
1111100010101000
1111100100000010
0000100101000011
0000100011010110
0000100101110110
0000011001101001
0000100101110000
0000011111010100
0000011110110011
0000101001010101
0000101111101001
0000100110001101
0000100001011000
1111100000101101
0000011001110000
0000101000010111
1111101001001110
0000100100010100
1111100001000111
1111101101001010
0000101101001001
1111110101001010
1111110011111100
1111110111000000
0000000001000000
0000000100000101
0000000101111101
0000000000001000
0000000011100100
1111111110010110
0000000001010010
1111111011001110
0000000110010100
1111111100000101
1111111111011010
1111111111110001
1111111100001000
0000010010000001
1111111111101010
1111111000010010
1111111010001100
1111110011111101
1111110011000100
1111110000001100
0000000111111100
0000001110111001
0000100101101100
1111100111101101
0000011111101001
0000010111100100
0000011110101100
0000101010001011
0000011010000010
1111001010110001
0000101110011101
1111010110100001
0000100000100010
1111010010001001
0000011101111011
1111100100111000
1111011111101010
0000010110011100
1111010111100011
1111010010010110
0000011110101101
0000101001111100
1111100000010110
0000011001001110
0000011010101010
0000001001111100
0000001101000100
0000000010000001
1111111000000011
0000000011000110
0000000011110110
0000000001011001
1111111100010001
0000000001100000
1111111010111110
0000000100101101
0000000100111000
0000000000001001
1111111011100101
1111111000001110
1111110101001101
1111110101010000
1111111000101111
0000000010010100
0000000101111111
1111110010001000
1111110011010100
0000000110010001
1111101101011000
0000001010011101
0000010110100010
0000011111000011
0000010010001010
0000011100111100
0000010110011100
1111011100110000
1111100010100101
0000100100000000
1111100000111100
0000100110001011
0000110000100011
1111001110111010
1111010100110001
0000011110101001
1111100000111011
0000010100001010
0000011110101011
1111011110010011
0000010110010111
1111011100000001
1111110101110001
1111101000111101
1111011010110011
1111111001100110
1111110111100100
0000000100110001
0000000101100110
0000000011111100
0000000010011010
1111111101111000
1111111100101110
0000000000111110
0000000001001101
0000000101011101
0000000100100111
1111111110000101
0000000011100101
0000000010000110
1111110101100100
0000000101111010
0000001000010111
0000001010101100
1111110000000110
0000010011110011
1111110011100100
1111110000111101
0000001101110100
1111101111011101
1111110000001101
1111100010000111
0000011000010001
0000010110010101
0000101000000010
0000011101001011
1111100010101011
0000100110101111
1111100000000000
0000110001111001
1111101000010010
0000100101111000
0000101010000000
1111101001000011
1111011011000011
1111101011010110
0000100100000101
0000100110111100
1111101000010010
1111011000100110
0000011111101000
0000011000011111
1111011111011110
0000001110011101
1111111000001001
0000000101111000
0000000011111000
1111111010101011
1111111111111011
0000000000011110
1111111010010110
1111111110101101
1111111011100101
0000000011100010
0000000100110010
1111111011011111
0000000010100001
0000000111101110
0000000010110110
0000001001100000
0000001000000111
1111111011011111
1111111000001010
0000010110001010
1111110011111010
1111110000011010
0000000110101111
