// memory data file (do not edit the following line - required for mem load use)
// instance=/Tb_m/memo_r
// format=mti addressradix=d dataradix=b version=1.0 wordsperline=1 noaddress
0000010001111001
0000010111010100
0000011101011000
1111110000010100
0000011001001001
1111011001101101
0000100000111000
0000011001011000
0000100111100010
1111011110100010
0000101100011001
0000101110100010
0000011110000010
1111011011100011
1111100101111110
0000101000010111
1111101010101011
1111100010011011
1111001100000001
0000011111101011
1111100010100001
0000100011001101
1111100110001001
0000100100110000
0000000011000010
1111111001010101
1111111000000101
1111110101000000
0000000010110101
0000000100001001
0000000101111111
1111111011001011
1111111101110001
1111111000111111
1111111110011011
0000000000001101
1111111111011110
1111111111100101
1111110110000100
1111110000011000
0000000111010000
1111111010010011
1111110111101100
1111110001111001
1111101111101101
0000001010101000
1111110000001011
0000011010111001
1111110101010011
1111101010011101
0000100000000010
0000010111011100
0000010101100010
1111010001010010
0000100000010110
1111011000001000
0000011100010110
0000011101010000
0000011100000111
1111010111010001
1111100101111001
0000101000111000
1111011011001011
0000010110110010
1111011110100010
0000101110100100
1111100011011100
0000010101000000
1111101000001101
0000100010011110
0000011110011111
1111011001001010
1111111000000100
1111110100010010
1111111001011110
1111111100001010
1111111110100101
0000001100101010
1111111111110100
1111111011001111
1111111110011011
0000000000001100
0000000011111100
0000000001010100
1111111101101001
1111111011000001
0000000000010000
1111111100000100
0000010000111101
0000001011001101
1111111000010100
0000010111101001
0000011000011011
1111110000110011
1111110000001011
0000000110001010
0000001111100000
1111101100101000
0000101100010010
1111101001011010
1111100100101011
1111010110011010
1111011000011110
1111100011100110
0000110011111111
1111011100101110
1111011101011010
1111101100010001
1111100001100000
0000011100100000
0000101111100101
0000100001011111
1111100011010000
1111011010110100
0000101010100100
0000010011111010
0000001000110010
0000011010000100
0000010110100001
1111100010001001
0000000101001100
1111110111100000
0000000111111001
0000000010000011
1111111001110100
0000001010110011
1111111011100111
1111111011101110
0000000001101111
0000000101000000
0000000000110001
1111111111111111
0000000011010101
1111111100111011
0000000011110110
0000000010110101
1111111000001000
1111110100010110
0000000111110100
0000001000000100
0000001011111000
0000001100000011
1111111001010011
0000010100101000
0000010010111011
0000010101111001
1111100011110000
1111101010000110
0000011010101000
0000100011001110
1111010101010010
1111100001001001
1111011010110111
1111100010001010
1111100110100111
1111001011000111
0000100001100001
1111011111010111
1111001010110011
0000100011101111
0000100011101011
0000100000101111
0000011110011011
0000011001100001
0000011101001000
0000010011000110
1111101100010110
1111101111110110
1111110100010111
0000000101000111
0000000001010010
1111111010001001
1111111010011011
0000001001100011
0000000110100011
0000000011101111
1111111110010000
1111111011011101
1111111001000001
0000000000101000
0000000000100110
1111111010110010
1111111111000000
0000001110011010
0000000110100001
1111111000011000
0000000111010111
1111101110000000
0000001100110011
0000001100010110
1111110101111101
0000010010010110
